9 zivota
An Interactive Fiction by Andrej
Release 1 / Serial number 230717 / Inform 7 v10.1.2 / D

U daljini čuješ ženski glas. Toliko je glasan da te probudio. Osjećaš se ukočeno i umorno kao da uopće nisi spavao. Mali prozor iznad kreveta je jedini izvor svijetla u inače potpuno mračnoj sobi. Ne bojiš se mraka, štoviše on ti godi. Odlučiš krenuti prema ženskom glasu.

Garaza (on Krevet)
Mjesto gdje provodiš noći odmarajući se. Ispod prozora se nalazi krevet bez jastuka. Jedini izlaz su smeđa vrata na sjeveru.

>n
Još uvijek ležis u krevetu
Čuju se tihi šumovi vode.

>n
Još uvijek ležis u krevetu

>n
Još uvijek ležis u krevetu
Zvukovi su malo bliži.

>n
Još uvijek ležis u krevetu

>n
Još uvijek ležis u krevetu
Zvukovi vode su prilično glasni.

>n
Još uvijek ležis u krevetu

>n
Još uvijek ležis u krevetu
Ta voda je sve bliže!

>n
Još uvijek ležis u krevetu

>n
Još uvijek ležis u krevetu
Voda izbija kroz pod!

>n
Još uvijek ležis u krevetu

>n
Još uvijek ležis u krevetu
Pools of water are on the ground.

>n
Još uvijek ležis u krevetu

>n
Još uvijek ležis u krevetu
Lokve vode su na tlu.

>n
Još uvijek ležis u krevetu

>n
Još uvijek ležis u krevetu
Voda je do koljena!

>n
Još uvijek ležis u krevetu

>n
Još uvijek ležis u krevetu
Voda je do struka!

>n
Još uvijek ležis u krevetu

>n
Još uvijek ležis u krevetu
Voda ti je do grudi..

>n
Još uvijek ležis u krevetu

>n
Još uvijek ležis u krevetu
Voda ti je iznad glave...

>n
Još uvijek ležis u krevetu

>n
Još uvijek ležis u krevetu

    *** Jedan život manje, još osam ***

Would you like to RESTART, RESTORE a saved game, QUIT or UNDO the last command?

* * *

>n
Još uvijek ležis u krevetu

>s
Kuhinja
Opis,  Opasna jama s kolcima blokira put prema istoku 

You can see Srebrna skrinja (closed) here.

>w
Blagavaona
You can see Konopac here.

>u
Tavan is locked up until 10:00 am.

>u
Tavan is locked up until 10:00 am.

>u
Tavan
You can see Crna skrinja (closed), Sjajilo, Labelo and Stit here.

>open crna skrinja
Ovo bolje ne otvarati.

    *** YOU DIED ***

Would you like to RESTART, RESTORE a saved game, QUIT or UNDO the last command?

>undo
Tavan
[Previous turn undone.]

>s
You can't go that way.

>d
Blagavaona
You can see Konopac here.

>take konopac
Taken.

>wear konopac
You put on Konopac.

>e
Kuhinja
Opis,  Mislim da se mogu zanjihati preko.

You can see Srebrna skrinja (closed) here.

>e
Ne mogu ovo preskočiti, ali se mogu zanjihati preko.
Uspio sam! Ovaj konopac će mi dobro doći i na povratku.

Hodnik
Dugi i hladni hodnik.

>d
Iz podruma se čuje glasno režanje.
Nije pametno biti u sobi s nekim tko reži od gladi

    *** YOU DIED ***

Would you like to RESTART, RESTORE a saved game, QUIT or UNDO the last command?

>undo
Hodnik
[Previous turn undone.]

>w
Ne mogu ovo preskočiti, ali se mogu zanjihati preko.
Uspio sam! Ovaj konopac će mi dobro doći i na povratku.

Kuhinja
Opis,  Mislim da se mogu zanjihati preko.

You can see Srebrna skrinja (closed) here.

>open srebrna skrinja
You open Srebrna skrinja, revealing Kost.

>take kost
Taken.

>e
Ne mogu ovo preskočiti, ali se mogu zanjihati preko.
Uspio sam! Ovaj konopac će mi dobro doći i na povratku.

Hodnik
Dugi i hladni hodnik.

>d
Iz podruma se čuje glasno režanje.
Ona kost iz Friždera bi mogla biti korisna
Podrum
Hladan i jos mracniji nego tvoja spavaća soba.

Iz mraka te promatraju dva jarka oka. U kutu ispod svijetiljke vidiš zlatni ključ. Režanje postaje sve jace i jace.

>take off konopac
You take off Konopac.

* * *

9 zivota
An Interactive Fiction by Andrej
Release 1 / Serial number 230717 / Inform 7 v10.1.2 / D

U daljini čuješ ženski glas. Toliko je glasan da te probudio. Osjećaš se ukočeno i umorno kao da uopće nisi spavao. Mali prozor iznad kreveta je jedini izvor svijetla u inače potpuno mračnoj sobi. Ne bojiš se mraka, štoviše on ti godi. Odlučiš krenuti prema ženskom glasu.

Garaza (on Krevet)
Mjesto gdje provodiš noći odmarajući se. Ispod prozora se nalazi krevet bez jastuka. Jedini izlaz su smeđa vrata na sjeveru.

>open Smeda vrata
You open Smeda vrata.

>n
(first getting off Krevet)

Kuhinja
Na sjeveru nalazi se Dnevna soba dok su na istoku vrata sa zamkom koja vode prema hodniku.

You can see Smeda vrata and Srebrna skrinja (closed) here.

>e
Ne mogu ovo preskočiti, ali se mogu zanjihati preko!
YOU DIED

    *** The End ***

Would you like to RESTART, RESTORE a saved game, QUIT or UNDO the last command?

>restart
U daljini se cuje zenski glas. Bio je toliko glasan da te probudio. Osjecas se ukoceno i umorno. Mali prozor iznad kreveta jedini je izvor svijetla u inace potpuno mracnoj sobi. Mrak ti godi i ne izaziva strah. Odlucis krenuti prema zenskom glasu.

9 zivota
An Interactive Fiction by Andrej
Release 1 / Serial number 230715 / Inform 7 v10.1.2 / D

Spavaca soba (on Krevet)
Mjesto gdje provodis najvise vremena. Ispod prozora se nalazi krevet bez jastuka. Jedini izlaz su smeđa vrata koja su cesto zatvorena.

You can see Smeda vrata here.

>open smeda vrata
You open Smeda vrata.

>n
(first getting off Krevet)

Kuhinja
Na sjeveru nalazi se Dnevna soba dok su na istoku vrata sa zamkom koja vode prema hodniku.

You can see Smeda vrata and Kost here.

>n
Dnevna soba

>s
Kuhinja
Na sjeveru nalazi se Dnevna soba dok su na istoku vrata sa zamkom koja vode prema hodniku.

You can see Smeda vrata and Kost here.

>e
Ne mogu ovo preskočiti, ali se mogu zanjihati preko!
YOU DIED

    *** The End ***

Would you like to RESTART, RESTORE a saved game, QUIT or UNDO the last command?

>restore
Restore failed.

Would you like to RESTART, RESTORE a saved game, QUIT or UNDO the last command?

>restart
U daljini se cuje zenski glas. Bio je toliko glasan da te probudio. Osjecas se ukoceno i umorno. Mali prozor iznad kreveta jedini je izvor svijetla u inace potpuno mracnoj sobi. Mrak ti godi i ne izaziva strah. Odlucis krenuti prema zenskom glasu.

9 zivota
An Interactive Fiction by Andrej
Release 1 / Serial number 230715 / Inform 7 v10.1.2 / D

Spavaca soba (on Krevet)
Mjesto gdje provodis najvise vremena. Ispod prozora se nalazi krevet bez jastuka. Jedini izlaz su smeđa vrata koja su cesto zatvorena.

You can see Smeda vrata here.

>pen Smeda vrata
That's not a verb I recognise.

>open Smeda vrata
You open Smeda vrata.

>n
(first getting off Krevet)

Kuhinja
Na sjeveru nalazi se Dnevna soba dok su na istoku vrata sa zamkom koja vode prema hodniku.

You can see Smeda vrata and Kost here.

>w
Blagavaona
You can see Konopac here.

>take Konopac
Taken.

>e
Kuhinja
Na sjeveru nalazi se Dnevna soba dok su na istoku vrata sa zamkom koja vode prema hodniku.

You can see Smeda vrata and Kost here.

>e
Ne mogu ovo preskočiti, ali se mogu zanjihati preko!
Konopac je korisniji ako ga nosiš a ne samo imaš.

    *** The End ***

Would you like to RESTART, RESTORE a saved game, QUIT or UNDO the last command?

* * *

>n
(first getting off Krevet)

Kuhinja
Na sjeveru nalazi se Dnevna soba dok su na istoku vrata sa zamkom koja vode prema hodniku.

You can see Smeda vrata and Srebrna skrinja (closed) here.

>n
Dnevna soba
You can see Zlatna skrinja (in which is Zlatnici) here.

>open zlatna skrinja
It isn't something you can open.

>s
Kuhinja
Na sjeveru nalazi se Dnevna soba dok su na istoku vrata sa zamkom koja vode prema hodniku.

You can see Smeda vrata and Srebrna skrinja (closed) here.

>w
Blagavaona
You can see Konopac here.

>take konopac
Taken.

* * *

>wear konopac
You put on Konopac.

>e
Kuhinja
Na sjeveru nalazi se Dnevna soba dok su na istoku vrata sa zamkom koja vode prema hodniku.

You can see Smeda vrata and Srebrna skrinja (closed) here.

>open srebrna skrinja
You open Srebrna skrinja, revealing Kost.

* * *

>take kost
Taken.

>e
Ne mogu ovo preskočiti.
Konopac će posluziti i na povrtaku
Hodnik
Dugi i hladni hodnik.

>e
You can't go that way.

>down
Glasno režanje s druge strane. Ona kost bi mogla biti korisna
Podrum
Hladan i jos mracniji nego tvoja spavaća soba.

You can see Stvorenje here.

>look
Podrum
Hladan i jos mracniji nego tvoja spavaća soba.

You can see Stvorenje here.

I beg your pardon?

>daj Stvorenje kost
Režanje je prestalo i zamjenilo ga je mljackanje. Stvorenje se smirilo. Sada je prilika za ugrabiti ključ.

I beg your pardon?

>i
You are carrying:
  Zlatni kljuc
  Kost
  Konopac (being worn)

>up
Hodnik
Dugi i hladni hodnik.

>w
Ne mogu ovo preskočiti.
Konopac će posluziti i na povrtaku
Kuhinja
Na sjeveru nalazi se Dnevna soba dok su na istoku vrata sa zamkom koja vode prema hodniku.

You can see Smeda vrata and Srebrna skrinja (empty) here.

>n
Dnevna soba
You can see Zlatna skrinja (in which is Zlatnici) here.

* * *

>open zlatna skrinja
It isn't something you can open.

>take zlatnici
Taken.

* * *

>n
(first getting off Krevet)

Kuhinja
Na sjeveru nalazi se Dnevna soba dok su na istoku vrata sa zamkom koja vode prema hodniku.

You can see Smeda vrata and Srebrna skrinja (closed) here.

>w
Blagavaona
You can see Konopac here.

* * *

>take Konopac
Taken.

>wear Konopac
You put on Konopac.

>e
Kuhinja
Na sjeveru nalazi se Dnevna soba dok su na istoku vrata sa zamkom koja vode prema hodniku.

You can see Smeda vrata and Kost here.

>e
Ne mogu ovo preskočiti, ali se sam već na drugoj strani!
Konopac je pukao, ali sva sreća nakon što sam se prenjihao,
Hodnik
Dugi i hladni hodnik.

>down
Podrum

* * *

>e
Ne mogu ovo preskočiti, ali se sam već na drugoj strani!
Konopac je pukao, ali sva sreća nakon što sam se prenjihao,
Hodnik
Dugi i hladni hodnik.

>w
Ne mogu ovo preskočiti, ali se mogu zanjihati preko!
YOU DIED

    *** The End ***

Would you like to RESTART, RESTORE a saved game, QUIT or UNDO the last command?

* * *

>take Konopac
Taken.

>wear Konpac
You can't see any such thing.

>wear Konopac
You put on Konopac.

* * *

>e
Ne mogu ovo preskočiti, ali se sam već na drugoj strani!
Konopac je pukao, ali sva sreća nakon što sam se prenjihao,
Hodnik
Dugi i hladni hodnik.

>w
Ne mogu ovo preskočiti, ali se sam već na drugoj strani!
Konopac je pukao, ali sva sreća nakon što sam se prenjihao,
Kuhinja
Na sjeveru nalazi se Dnevna soba dok su na istoku vrata sa zamkom koja vode prema hodniku.

You can see Smeda vrata and Kost here.

* * *

9 zivota
An Interactive Fiction by Andrej
Release 1 / Serial number 230717 / Inform 7 v10.1.2 / D

U daljini čuješ ženski glas. Toliko je glasan da te probudio. Osjećaš se ukočeno i umorno kao da uopće nisi spavao. Mali prozor iznad kreveta je jedini izvor svijetla u inače potpuno mračnoj sobi. Ne bojiš se mraka, štoviše on ti godi. Odlučiš krenuti prema ženskom glasu.

Garaza (on Krevet)
Mjesto gdje provodiš noći odmarajući se. Ispod prozora se nalazi krevet bez jastuka. Jedini izlaz su smeđa vrata na sjeveru.

>open smeda vrata
Još uvijek ležiš u krevetu

>n
Još uvijek ležis u krevetu

>go through smeda
Još uvijek ležis u krevetu

* * *

>n
Još uvijek ležis u krevetu

>n
Dnevna soba
You can see Zlatna skrinja (closed) here.

>s
Kuhinja
Na sjeveru nalazi se Dnevna soba dok su na istoku vrata sa zamkom koja vode prema hodniku.

You can see Smeda vrata and Srebrna skrinja (closed) here.

* * *

>w
Blagavaona
You can see Konopac here.

>up
Tavan
Došli ste na tavan. Ovdje vidis stranca u bjelo crnom kaputu koji se cini nesto prodaje.

You can see Crna skrinja (closed) here.

>open crna skrinj
I only understood you as far as wanting to open Crna skrinja.

>open crna skrinja
Jos jedna skrinja YOU DIED

    *** The End ***

Would you like to RESTART, RESTORE a saved game, QUIT or UNDO the last command?

* * *

>n
Dnevna soba
You can see Zlatna skrinja (closed) here.

>take zlatnici
You can't see any such thing.

>s
Kuhinja
Na sjeveru nalazi se Dnevna soba dok su na istoku vrata sa zamkom koja vode prema hodniku.

You can see Smeda vrata and Srebrna skrinja (closed) here.

* * *

>e
Ne mogu ovo preskočiti.
Konopac će posluziti i na povrtaku
Hodnik
Dugi i hladni hodnik.

>down
Glasno režanje s druge strane. Ona kost bi mogla biti korisna
Podrum
Hladan i jos mracniji nego tvoja spavaća soba.

You can see Stvorenje here.

>look stvorenje
Iz mraka te promatraju dva jarka oka. U kutu ispod svijetiljke vidis zlatni kljuc. Režanje postaje sve jace i jace.

>daj Stvorenje kost
Režanje je prestalo i zamjenilo ga je mljackanje. Stvorenje se smirilo. Sada je prilika za ugrabiti ključ.

>up
Hodnik
Dugi i hladni hodnik.

* * *

>w
Ne mogu ovo preskočiti.
Konopac će posluziti i na povrtaku
Kuhinja
Na sjeveru nalazi se Dnevna soba dok su na istoku vrata sa zamkom koja vode prema hodniku.

You can see Smeda vrata and Srebrna skrinja (empty) here.

>n
Dnevna soba
You can see Zlatna skrinja (closed) here.

>open zlatna skrinja
It seems to be locked.

>use zlatni kljuc on zlatna skrinja
That's not a verb I recognise.

>unlock zlatna skrinja with zlatni kljuc
You unlock Zlatna skrinja.

>open skrinja
You open Zlatna skrinja, revealing Zlatnici.

>take zlatnici
Taken.

>s
Kuhinja
Na sjeveru nalazi se Dnevna soba dok su na istoku vrata sa zamkom koja vode prema hodniku.

You can see Smeda vrata and Srebrna skrinja (empty) here.

>e
Ne mogu ovo preskočiti.
Konopac će posluziti i na povrtaku
Hodnik
Dugi i hladni hodnik.

>w
Ne mogu ovo preskočiti.
Konopac će posluziti i na povrtaku
Kuhinja
Na sjeveru nalazi se Dnevna soba dok su na istoku vrata sa zamkom koja vode prema hodniku.

You can see Smeda vrata and Srebrna skrinja (empty) here.

>w
Blagavaona

>look
Blagavaona

>i
You are carrying:
  Zlatnici
  Zlatni kljuc
  Konopac (being worn)

* * *

>n
Još uvijek ležis u krevetu

>open Srebrna Skrinja
You open Srebrna skrinja, revealing Kost.

>take kost
Taken.

>w
Blagavaona
You can see Konopac here.

* * *

>wear Konopac
You put on Konopac.

>e
Kuhinja
Na sjeveru nalazi se Dnevna soba dok su na istoku vrata sa zamkom koja vode prema hodniku.

You can see Smeda vrata and Srebrna skrinja (empty) here.

>e
Ne mogu ovo preskočiti, ali se sam već na drugoj strani!
Konopac je pukao, ali sva sreća nakon što sam se prenjihao,
Hodnik
Dugi i hladni hodnik.

>down
Ne mogu ovo preskočiti, ali se sam već na drugoj strani!
Test1
Podrum
Hladan i jos mracniji nego tvoja spavaća soba.

Iz mraka te promatraju dva jarka oka. U kutu ispod svijetiljke vidis zlatni kljuc.

>down
You can't go that way.

* * *

>n
Još uvijek ležis u krevetu

>w
Blagavaona
You can see Konopac here.

>e
Kuhinja
Opis za kuhinju.

You can see Smeda vrata and Kost here.

>e
Ne mogu ovo preskočiti, ali se mogu zanjihati preko!
YOU DIED

    *** The End ***

Would you like to RESTART, RESTORE a saved game, QUIT or UNDO the last command?

* * *

>e
Kuhinja
Na sjeveru nalazi se Dnevna soba dok su na istoku vrata sa zamkom koja vode prema hodniku.

You can see Smeda vrata and Srebrna skrinja (closed) here.

>e
Ne mogu ovo preskočiti.
Konopac će posluziti i na povrtaku
Hodnik
Dugi i hladni hodnik.

>down
Glasno režanje s druge straneTrebati ce mi nesto da mu utažm gladYOU DIED

    *** The End ***

Would you like to RESTART, RESTORE a saved game, QUIT or UNDO the last command?

>n
Please give one of the answers above.

Would you like to RESTART, RESTORE a saved game, QUIT or UNDO the last command?

>e
Please give one of the answers above.

Would you like to RESTART, RESTORE a saved game, QUIT or UNDO the last command?

>s
Please give one of the answers above.

Would you like to RESTART, RESTORE a saved game, QUIT or UNDO the last command?

>w
Please give one of the answers above.

Would you like to RESTART, RESTORE a saved game, QUIT or UNDO the last command?

>up
Please give one of the answers above.

Would you like to RESTART, RESTORE a saved game, QUIT or UNDO the last command?

>down
Please give one of the answers above.

Would you like to RESTART, RESTORE a saved game, QUIT or UNDO the last command?

* * *

>e
Ne mogu ovo preskočiti.
Konopac će posluziti i na povrtaku
Hodnik
Dugi i hladni hodnik.

>d
Glasno režanje s druge strane. Ona kost bi mogla biti korisna
Podrum
Hladan i jos mracniji nego tvoja spavaća soba.

You can see Stvorenje here.

>daj Stvorenje kost
Režanje je prestalo i zamjenilo ga je mljackanje. Stvorenje se smirilo. Sada je prilika za ugrabiti ključ.

>u
Hodnik
Dugi i hladni hodnik.

>w
Ne mogu ovo preskočiti.
Konopac će posluziti i na povrtaku
Kuhinja
Na sjeveru nalazi se Dnevna soba dok su na istoku vrata sa zamkom koja vode prema hodniku.

You can see Smeda vrata and Srebrna skrinja (empty) here.

>n
Dnevna soba
Na sjeveroistoku se nalaze Crvena vrata dok je na sjeverozapadu kupaona.

You can see Zlatna skrinja (closed) here.

>unlock zlatna skrinja witk zlatni kljuc
I didn't understand that sentence.

>unlock zlatna skrinja with zlatni kljuc
You unlock Zlatna skrinja.

>open zlatna skrinja
You open Zlatna skrinja, revealing Fond.

* * *

>take fond
Taken.

>s
Kuhinja
Na sjeveru nalazi se Dnevna soba dok su na istoku vrata sa zamkom koja vode prema hodniku.

You can see Smeda vrata and Srebrna skrinja (empty) here.

>w
Blagavaona

>u
Tavan
Došli ste na tavan. Ovdje vidis stranca u bjelo crnom kaputu koji se cini nesto prodaje.

You can see Crna skrinja (closed), Sjajilo and Labelo here.

>take sjajilo
Moraš prvo platiti sjajilo na kasi!

>put sjajilo on kasa
Račun za sjajilo je 15 €. Molim Vas stavite fond na kasu.

>put fond on kasa
Hvala Vam na kupnji i doviđenja. NE ZABORAVITE uzeti sjajilo! Preostalo Vam je još 185 €.

>take sjajilo
Taken.

>take labelo
Moraš prvo platiti labelo na kasi!

>put labelo on kasa
Račun za labelo je 3 €. Molim Vas stavite fond na kasu.

>put fond on kasa
Hvala Vam na kupnji i doviđenja. NE ZABORAVITE uzeti labelo! Preostalo Vam je još 182 €.

>take labelo
Taken.

>d
Blagavaona

>e
Kuhinja
Na sjeveru nalazi se Dnevna soba dok su na istoku vrata sa zamkom koja vode prema hodniku.

You can see Smeda vrata and Srebrna skrinja (empty) here.

>ne
You can't go that way.

>n
Dnevna soba
Na sjeveroistoku se nalaze Crvena vrata dok je na sjeverozapadu kupaona.

You can see Zlatna skrinja (empty) here.

* * *

>w
Blagavaona

>e
Kuhinja
Na sjeveru nalazi se Dnevna soba dok su na istoku vrata sa zamkom koja vode prema hodniku.

You can see Smeda vrata and Srebrna skrinja (empty) here.

>n
Dnevna soba
You can see Zlatna skrinja (closed) here.

>use zlatni kljuc to unlock zlatna skrinja
That's not a verb I recognise.

>unlock zlatna skrinja with zlatni kljuc
You unlock Zlatna skrinja.

* * *

>e
You can't go that way.

>d
Glasno režanje s druge strane. Ona kost bi mogla biti korisna
Podrum
Hladan i jos mracniji nego tvoja spavaća soba.

You can see Stvorenje here.

* * *

>n
Dnevna soba
You can see Zlatna skrinja (closed) here.

>unlock zlata skrinja with zlatni kljuc
You can't see any such thing.

>i
You are carrying:
  Zlatni kljuc
  Konopac (being worn)

>unlock zlata skrinja with zlatni kljuc
You can't see any such thing.

>unlock zlatna skrinja with zlatni kljuc
You unlock Zlatna skrinja.

* * *

>i
You are carrying:
  Zlatni kljuc
  Konopac (being worn)

* * *

>up
Tavan
Došli ste na tavan. Ovdje vidis stranca u bjelo crnom kaputu koji se cini nesto prodaje.

You can see Crna skrinja (closed) here.

>d
Blagavaona
You can see Konopac here.

* * *

>d
Glasno režanje s druge strane. Ona kost bi mogla biti korisna
Podrum
Hladan i jos mracniji nego tvoja spavaća soba.

You can see Stvorenje here.

>look stvorenje
Iz mraka te promatraju dva jarka oka. U kutu ispod svijetiljke vidis zlatni kljuc. Režanje postaje sve jace i jace.

* * *

>u
Hodnik
Dugi i hladni hodnik.

>e
You can't go that way.

I beg your pardon?

>w
Ne mogu ovo preskočiti.
Konopac će posluziti i na povrtaku
Kuhinja
Na sjeveru nalazi se Dnevna soba dok su na istoku vrata sa zamkom koja vode prema hodniku.

You can see Smeda vrata and Srebrna skrinja (empty) here.

* * *

>n
Dnevna soba
You can see Zlatna skrinja (closed) here.

>open skrinja
It seems to be locked.

>unlock zlatna skrinja with zlatni kljuc
You unlock Zlatna skrinja.

* * *

>i
You are carrying:
  Zlatni kljuc
  Konopac (being worn)

>skupljen Fond
That's not a verb I recognise.

>take fond
Taken.

>look donf
You can't see any such thing.

>look fond
200 €.

* * *

9 zivota
An Interactive Fiction by Andrej
Release 1 / Serial number 230717 / Inform 7 v10.1.2 / D

U daljini čuješ ženski glas. Toliko je glasan da te probudio. Osjećaš se ukočeno i umorno kao da uopće nisi spavao. Mali prozor iznad kreveta je jedini izvor svijetla u inače potpuno mračnoj sobi. Ne bojiš se mraka, štoviše on ti godi. Odlučiš krenuti prema ženskom glasu.

Garaza (on Krevet)
Mjesto gdje provodiš noći odmarajući se. Ispod prozora se nalazi krevet bez jastuka. Jedini izlaz su smeđa vrata na sjeveru.

>stad
That's not a verb I recognise.

>stand
You get off Krevet.

Spavaca soba
Mjesto gdje provodis najvise vremena. Ispod prozora se nalazi krevet bez jastuka. Jedini izlaz su smeđa vrata koja su cesto zatvorena.

You can see Smeda vrata here.

>open smeda vrata
You open Smeda vrata.

>n
Kuhinja
Na sjeveru nalazi se Dnevna soba dok su na istoku vrata sa zamkom koja vode prema hodniku.

You can see Smeda vrata and Srebrna skrinja (closed) here.

>w
Blagavaona
You can see Konopac here.

* * *

>n
Dnevna soba
Na sjeveroistoku se nalaze Crvena vrata dok je na sjeverozapadu kupaona.

You can see Zlatna skrinja (closed) here.

>unlock zlatna skrinja with zlatni kljuc
You unlock Zlatna skrinja.

* * *

>u
Tavan
Došli ste na tavan. Ovdje vidis stranca u bjelo crnom kaputu koji se cini nesto prodaje.

You can see Crna skrinja (closed), Sjajilo and Labelo here.

>take labelo
Moraš prvo platiti labelo na kasi!

* * *

>put labelo on kasa
Račun za labelo je 3 €. Molim Vas stavite fond na kasu.

>put fond on kasa
Hvala Vam na kupnji i doviđenja. NE ZABORAVITE uzeti labelo! Preostalo Vam je još 197 €.

>take labelo
Taken.

* * *

>e
Kuhinja
Na sjeveru nalazi se Dnevna soba dok su na istoku vrata sa zamkom koja vode prema hodniku.

You can see Smeda vrata and Srebrna skrinja (empty) here.

>n
Dnevna soba
Na sjeveroistoku se nalaze Crvena vrata dok je na sjeverozapadu kupaona.

You can see Zlatna skrinja (empty) here.

>sw
You can't go that way.

>unlock crvena vrata with labelo
You can't see any such thing.

>i
You are carrying:
  Labelo
  Fond
  Zlatni kljuc
  Konopac (being worn)

>south west
I only understood you as far as wanting to (go) south.

>southwest
You can't go that way.

>unlock Crvena vrata with Labelo
You can't see any such thing.

>i
You are carrying:
  Labelo
  Fond
  Zlatni kljuc
  Konopac (being worn)

>northeast
You can't go that way.

>unlock Crvena vrata with Labelo
You can't see any such thing.

>look
Dnevna soba
Na sjeveroistoku se nalaze Crvena vrata dok je na sjeverozapadu kupaona.

You can see Zlatna skrinja (empty) here.

>unlock Crvena vrata with Labelo
You can't see any such thing.

>sw
You can't go that way.

>ne
You can't go that way.

>northeast
You can't go that way.

>notheast
That's not a verb I recognise.

>northeast
You can't go that way.

>northeast
You can't go that way.

>northwest
You can't go that way.

>s
Kuhinja
Na sjeveru nalazi se Dnevna soba dok su na istoku vrata sa zamkom koja vode prema hodniku.

You can see Smeda vrata and Srebrna skrinja (empty) here.

>n
Dnevna soba
Na sjeveroistoku se nalaze Crvena vrata dok je na sjeverozapadu kupaona.

You can see Zlatna skrinja (empty) here.

>nw
You can't go that way.

>w
You can't go that way.

>e
You can't go that way.

>w
You can't go that way.

>s
Kuhinja
Na sjeveru nalazi se Dnevna soba dok su na istoku vrata sa zamkom koja vode prema hodniku.

You can see Smeda vrata and Srebrna skrinja (empty) here.

* * *

9 zivota
An Interactive Fiction by Andrej
Release 1 / Serial number 230717 / Inform 7 v10.1.2 / D

U daljini čuješ ženski glas. Toliko je glasan da te probudio. Osjećaš se ukočeno i umorno kao da uopće nisi spavao. Mali prozor iznad kreveta je jedini izvor svijetla u inače potpuno mračnoj sobi. Ne bojiš se mraka, štoviše on ti godi. Odlučiš krenuti prema ženskom glasu.

Garaza (on Krevet)
Mjesto gdje provodiš noći odmarajući se. Ispod prozora se nalazi krevet bez jastuka. Jedini izlaz su smeđa vrata na sjeveru.

>stand
You get off Krevet.

Garaza
Mjesto gdje provodiš noći odmarajući se. Ispod prozora se nalazi krevet bez jastuka. Jedini izlaz su smeđa vrata na sjeveru.

*** Run-time problem P21: Attempt to look up a non-existent correspondence in the table 'Table of Water Levels'.

Glulxe fatal error: Memory access out of range (6C756C01)

>n
(first opening Smeda vrata)

Dnevna soba
You can see Smeda vrata here.

* * *

>stand
You get off Krevet.

Garaza
Mjesto gdje provodiš noći odmarajući se. Ispod prozora se nalazi krevet bez jastuka. Jedini izlaz su smeđa vrata na sjeveru.

*** Run-time problem P21: Attempt to look up a non-existent correspondence in the table 'Table of Water Levels'.

Glulxe fatal error: Memory access out of range (6C756C01)

>open door
You can't see any such thing.

>open smeda vrata
You open Smeda vrata.

>n
Kuhinja
Ovdje uvijek dobijem nešto za pojesti, ali nisam stalno dobrodošao. Prolaz prema sjeveru i zapadu su slobodni. Opasna jama s kolcima blokira put prema istoku.

You can see Frizder (closed) here.

>look frizder
Najbolje meso se nalazi ovdje.

>w
Blagovaonica
Stara soba sa žutim tapetama koja vodi prema tavanu.

You can see Konopac here.

>look Konopac
Ovo će mi dobro doći.

* * *

>stand
You get off Krevet.

Garaza
Mjesto gdje provodiš noći odmarajući se. Ispod prozora se nalazi krevet bez jastuka. Jedini izlaz su smeđa vrata na sjeveru.

*** Run-time problem P21: Attempt to look up a non-existent correspondence in the table 'Table of Water Levels'.

Glulxe fatal error: Memory access out of range (6C756C01)

>open smeda vrata
You open Smeda vrata.

>n
Kuhinja
Ovdje uvijek dobijem nešto za pojesti, ali nisam stalno dobrodošao. Prolaz prema sjeveru i zapadu su slobodni. Opasna jama s kolcima blokira put prema istoku.

You can see Frizider (closed) here.

>e
Ne mogu ovo preskočiti.
YOU DIED

    *** The End ***

Would you like to RESTART, RESTORE a saved game, QUIT or UNDO the last command?

>restart
U daljini se cuje zenski glas. Bio je toliko glasan da te probudio. Osjecas se ukoceno i umorno. Mali prozor iznad kreveta jedini je izvor svijetla u inace potpuno mracnoj sobi. Mrak ti godi i ne izaziva strah. Odlucis krenuti prema zenskom glasu.

9 zivota
An Interactive Fiction by Andrej
Release 1 / Serial number 230715 / Inform 7 v10.1.2 / D

Spavaca soba (on Krevet)
Mjesto gdje provodis najvise vremena. Ispod prozora se nalazi krevet bez jastuka. Jedini izlaz su smeđa vrata koja su cesto zatvorena.

You can see Smeda vrata here.

>stand
You get off Krevet.

Spavaca soba
Mjesto gdje provodis najvise vremena. Ispod prozora se nalazi krevet bez jastuka. Jedini izlaz su smeđa vrata koja su cesto zatvorena.

You can see Smeda vrata here.

>n
(first opening Smeda vrata)

Kuhinja
Na sjeveru nalazi se Dnevna soba dok su na istoku vrata sa zamkom koja vode prema hodniku.

You can see Smeda vrata and Srebrna skrinja (closed) here.

>w
Blagavaona
You can see Konopac here.

>take
(Konopac)
Taken.

>n
You can't go that way.

>up
Tavan
Došli ste na tavan. Ovdje vidis stranca u bjelo crnom kaputu koji se cini nesto prodaje.

You can see Crna skrinja (closed), Sjajilo, Labelo and Stit here.

>open crna skrinja
Jos jedna skrinja YOU DIED

    *** The End ***

Would you like to RESTART, RESTORE a saved game, QUIT or UNDO the last command?

>restart
U daljini se cuje zenski glas. Bio je toliko glasan da te probudio. Osjecas se ukoceno i umorno. Mali prozor iznad kreveta jedini je izvor svijetla u inace potpuno mracnoj sobi. Mrak ti godi i ne izaziva strah. Odlucis krenuti prema zenskom glasu.

9 zivota
An Interactive Fiction by Andrej
Release 1 / Serial number 230715 / Inform 7 v10.1.2 / D

Spavaca soba (on Krevet)
Mjesto gdje provodis najvise vremena. Ispod prozora se nalazi krevet bez jastuka. Jedini izlaz su smeđa vrata koja su cesto zatvorena.

You can see Smeda vrata here.

* * *

>stand
You get off Krevet.

Spavaca soba
Mjesto gdje provodis najvise vremena. Ispod prozora se nalazi krevet bez jastuka. Jedini izlaz su smeđa vrata koja su cesto zatvorena.

You can see Smeda vrata here.

>open
(Smeda vrata)
You open Smeda vrata.

>n
Kuhinja
Na sjeveru nalazi se Dnevna soba dok su na istoku vrata sa zamkom koja vode prema hodniku.

You can see Smeda vrata and Srebrna skrinja (closed) here.

* * *

>take
(Konopac)
Taken.

>e
Kuhinja
Na sjeveru nalazi se Dnevna soba dok su na istoku vrata sa zamkom koja vode prema hodniku.

You can see Smeda vrata and Srebrna skrinja (closed) here.

>e
Ne mogu ovo preskočiti.
Konopac je korisniji ako ga nosiš a ne samo imaš. YOU DIED

    *** The End ***

Would you like to RESTART, RESTORE a saved game, QUIT or UNDO the last command?

>restart
U daljini se cuje zenski glas. Bio je toliko glasan da te probudio. Osjecas se ukoceno i umorno. Mali prozor iznad kreveta jedini je izvor svijetla u inace potpuno mracnoj sobi. Mrak ti godi i ne izaziva strah. Odlucis krenuti prema zenskom glasu.

9 zivota
An Interactive Fiction by Andrej
Release 1 / Serial number 230715 / Inform 7 v10.1.2 / D

Spavaca soba (on Krevet)
Mjesto gdje provodis najvise vremena. Ispod prozora se nalazi krevet bez jastuka. Jedini izlaz su smeđa vrata koja su cesto zatvorena.

You can see Smeda vrata here.

>n
(first getting off Krevet)
(first opening Smeda vrata)

Kuhinja
Na sjeveru nalazi se Dnevna soba dok su na istoku vrata sa zamkom koja vode prema hodniku.

You can see Smeda vrata and Srebrna skrinja (closed) here.

>e
Ne mogu ovo preskočiti.
YOU DIED

    *** The End ***

Would you like to RESTART, RESTORE a saved game, QUIT or UNDO the last command?

* * *

>n
(first getting off Krevet)
(first opening Smeda vrata)

Kuhinja
Na sjeveru nalazi se Dnevna soba dok su na istoku vrata sa zamkom koja vode prema hodniku.

You can see Smeda vrata and Srebrna skrinja (closed) here.

>w
Blagavaona
You can see Konopac here.

* * *

>take
(Konopac)
Taken.

>wear konopac
You put on Konopac.

* * *

>open srebrna skrinja
You open Srebrna skrinja, revealing Kost.

>take kst
You can't see any such thing.

>take kost
Taken.

>look kost
Ne volis kosti, ali kad si gladan sve je dobro.

>e
Ne mogu ovo preskočiti.
Konopac će posluziti i na povrtaku
Hodnik
Dugi i hladni hodnik.

* * *

>down
Glasno režanje s druge strane. Ona kost bi mogla biti korisna
Podrum
Hladan i jos mracniji nego tvoja spavaća soba.

You can see Stvorenje here.

>take stvorenje
I don't suppose Stvorenje would care for that.

>look stvorenje
Iz mraka te promatraju dva jarka oka. U kutu ispod svijetiljke vidis zlatni kljuc. Režanje postaje sve jace i jace.

>take zlatni ključ
You can't see any such thing.

>take zlatni kljuc
You can't see any such thing.

>daj stvorenje kost
Režanje je prestalo i zamjenilo ga je mljackanje. Stvorenje se smirilo. Sada je prilika za ugrabiti ključ.

>take ključ
You can't see any such thing.

>n
You can't go that way.

>up
Hodnik
Dugi i hladni hodnik.

* * *

>n
Dnevna soba
Na sjeveroistoku se nalaze Crvena vrata dok je na sjeverozapadu kupaona.

You can see Zlatna skrinja (closed) here.

>ne
(first opening Crvena vrata)
It seems to be locked.

>i
You are carrying:
  Zlatni kljuc
  Konopac (being worn)

>use zlatni ključ
That's not a verb I recognise.

>unlock crvena vrata
What do you want to unlock Crvena vrata with?

>with zlatni ključ
You can't see any such thing.

>nw
Cini se da m treba nesto maso kako bi ovdje ušao

>nw
Cini se da m treba nesto maso kako bi ovdje ušao

>look
Dnevna soba
Na sjeveroistoku se nalaze Crvena vrata dok je na sjeverozapadu kupaona.

You can see Zlatna skrinja (closed) here.

>open zlatna skrinja
It seems to be locked.

>unlock zlatnna skrinja with zlatni ključ
You can't see any such thing.

>unlock zlatna skrinja with zlatni ključ
I only understood you as far as wanting to unlock Zlatna skrinja with Zlatni kljuc.

>unlock zlatna skrinja
What do you want to unlock Zlatna skrinja with?

>zlatni kljuc
You unlock Zlatna skrinja.

>open
What do you want to open?

>open zlatna skrinja
You open Zlatna skrinja, revealing Fond.

* * *

>take fond
Taken.

>look fond
200 €.

>s
Kuhinja
Na sjeveru nalazi se Dnevna soba dok su na istoku vrata sa zamkom koja vode prema hodniku.

You can see Smeda vrata and Srebrna skrinja (empty) here.

* * *

>w
Blagavaona

>n
You can't go that way.

* * *

>up
Tavan
Došli ste na tavan. Ovdje vidis stranca u bjelo crnom kaputu koji se cini nesto prodaje.

You can see Crna skrinja (closed), Sjajilo, Labelo and Stit here.

>take labelo
Moraš prvo platiti labelo na kasi!

>plati
That's not a verb I recognise.

>put labelo na kasu
I didn't understand that sentence.

>put labelo on kasa
Račun za labelo je 3 €. Molim Vas stavite fond na kasu.

>fond on kasa
That's not a verb I recognise.

>put fond on  kasa
Hvala Vam na kupnji i doviđenja. NE ZABORAVITE uzeti labelo! Preostalo Vam je još 197 €.

>n
You can't go that way.

>e
You can't go that way.

>down
Blagavaona

>i
You are carrying:
  Fond
  Zlatni kljuc
  Konopac (being worn)

>up
Tavan
Došli ste na tavan. Ovdje vidis stranca u bjelo crnom kaputu koji se cini nesto prodaje.

You can see Crna skrinja (closed), Sjajilo, Labelo and Stit here.

>take labelo
Taken.

>down
Blagavaona

>e
Kuhinja
Na sjeveru nalazi se Dnevna soba dok su na istoku vrata sa zamkom koja vode prema hodniku.

You can see Smeda vrata and Srebrna skrinja (empty) here.

* * *

>n
Dnevna soba
Na sjeveroistoku se nalaze Crvena vrata dok je na sjeverozapadu kupaona.

You can see Zlatna skrinja (empty) here.

>n
You can't go that way.

>ne
(first opening Crvena vrata)
It seems to be locked.

>unlock crvena vrata with labelo
You unlock Crvena vrata.

>open crvena vrata
You open Crvena vrata.

>ne
Smocnica
U sobi se nalazi bocica na sredini stola.

You can see Bocica here.

>look bocica
Izgleda kao kolomast.

>take kolomast
You can't see any such thing.

>take bocica
Taken.

>sw
Dnevna soba
Na sjeveroistoku se nalaze Crvena vrata dok je na sjeverozapadu kupaona.

You can see Zlatna skrinja (empty) here.

>nw
Kupaona
Bijela soba s tvojim imenom na zidu - Eugen.

>se
Dnevna soba
Na sjeveroistoku se nalaze Crvena vrata dok je na sjeverozapadu kupaona.

You can see Zlatna skrinja (empty) here.

>s
Kuhinja
Na sjeveru nalazi se Dnevna soba dok su na istoku vrata sa zamkom koja vode prema hodniku.

You can see Smeda vrata and Srebrna skrinja (empty) here.

* * *

>w
Blagavaona

>up
Tavan
Došli ste na tavan. Ovdje vidis stranca u bjelo crnom kaputu koji se cini nesto prodaje.

You can see Crna skrinja (closed), Sjajilo and Stit here.

>take stit
Moraš prvo platiti stit na kasi!

>put stit on kasa
Racun za stit je 50€. Molim Vas stavite fond na kasu.

>put fond on kasa
Hvala Vam na kupnji i doviđenja. NE ZABORAVITE uzeti labelo! Preostalo Vam je još 147 €.

>take stit
Taken.

>d
Blagavaona

* * *

>n
Dnevna soba
Na sjeveroistoku se nalaze Crvena vrata dok je na sjeverozapadu kupaona.

You can see Zlatna skrinja (empty) here.

>nw
Kupaona
Bijela soba s tvojim imenom na zidu - Eugen.

>w
Ne mogu ovo preskočiti.
Konopac je korisniji ako ga nosiš a ne samo imaš. YOU DIED

    *** The End ***

Would you like to RESTART, RESTORE a saved game, QUIT or UNDO the last command?

>undo
Kupaona
[Previous turn undone.]

>ware shield
That's not a verb I recognise.

>wear
What do you want to wear?

>wear stit
You put on Stit.

>west
Ne mogu ovo preskočiti.
Konopac će posluziti i na povrtaku
Vrt
Stit je bio jednokratan. Nema natrag.

>e
Kupaona
Bijela soba s tvojim imenom na zidu - Eugen.

>i
You are carrying:
  Stit (being worn)
  Bocica
  Labelo
  Fond
  Zlatni kljuc
  Konopac (being worn)

>w
Ne mogu ovo preskočiti.
Konopac će posluziti i na povrtaku
Vrt
Stit je bio jednokratan. Nema natrag.

>undo
Kupaona
[Previous turn undone.]

>west
Ne mogu ovo preskočiti.
Konopac će posluziti i na povrtaku
Vrt
Stit je bio jednokratan. Nema natrag.

>undo
Kupaona
[Previous turn undone.]

>wear shield
You can't see any such thing.

>i
You are carrying:
  Stit (being worn)
  Bocica
  Labelo
  Fond
  Zlatni kljuc
  Konopac (being worn)

* * *

>w
Ne mogu ovo preskočiti.
Konopac će posluziti i na povrtaku
Vrt
Stit je bio jednokratan. Nema natrag.

>e
Kupaona
Bijela soba s tvojim imenom na zidu - Eugen.

>w
Ne mogu ovo preskočiti.
Konopac će posluziti i na povrtaku
Vrt
Stit je bio jednokratan. Nema natrag.

* * *

>undo
Kupaona
[Previous turn undone.]

>i
You are carrying:
  Stit (being worn)
  Bocica
  Labelo
  Fond
  Zlatni kljuc
  Konopac (being worn)

>west
Ne mogu ovo preskočiti.
Konopac će posluziti i na povrtaku
Vrt
Stit je bio jednokratan. Nema natrag.

>Eugen
Bacen si u zrak
*** Run-time problem P61: Attempt to move the player off-stage.

>take zeleni kljuc
You can't see any such thing.

>unlock zelena vrata with zeleni kljuc
You can't see any such thing.

>open zelena vrata
You can't see any such thing.

>n
You can't go that way.

>go through
What do you want to go through?

>zelena vrata
You can't see any such thing.

>go through zelena vrata
You can't see any such thing.

>look
Vrt
Stit je bio jednokratan. Nema natrag.

>open door
You can't see any such thing.

>open zelena vrata
You can't see any such thing.

* * *

>n
Kuhinja
Ovdje uvijek dobijem nešto za pojesti, ali nisam stalno dobrodošao. Prolaz prema sjeveru i zapadu su slobodni. Opasna jama s kolcima blokira put prema istoku.

You can see Frizider (closed) here.

>look frider
You can't see any such thing.

>look frizder
You see nothing special about Frizder.

* * *

>n
Kuhinja
Ovdje uvijek dobijem nešto za pojesti, ali nisam stalno dobrodošao. Prolaz prema sjeveru i zapadu su slobodni. Opasna jama s kolcima blokira put prema istoku.

You can see Frizider (closed) here.

>n
Dnevna soba
Na sjeveroistoku se nalaze Crvena vrata dok je na sjeverozapadu kupaona.

You can see Zlatna skrinja (closed) here.

* * *

>ne
(first opening Crvena vrata)
It seems to be locked.

>ne
(first opening Crvena vrata)
It seems to be locked.

* * *

>n
Kuhinja
Ovdje uvijek dobijem nešto za pojesti, ali nisam stalno dobrodošao. Prolaz prema sjeveru i zapadu su slobodni. Opasna jama s kolcima blokira put prema istoku.

You can see Frizider (closed) here.

>w
Blagovaonica
Stara soba sa žutim tapetama koja vodi prema tavanu.

You can see Konopac here.

>e
Kuhinja
Opis,  Opasna jama s kolcima blokira put prema istoku 

You can see Smeda vrata and Srebrna skrinja (closed) here.

>w
Blagavaona
You can see Konopac here.

* * *

>take konopac
Taken.

>e
Kuhinja
Opis,  Mislim da se mogu zanjihati preko.

You can see Smeda vrata and Srebrna skrinja (closed) here.

>n
Dnevna soba
Opis, Velika crvena vrata vode prema sjeveroistoku  Uvijek su zaključana 

You can see Crvena vrata and Zlatna skrinja (closed) here.

>s
Kuhinja
Opis,  Mislim da se mogu zanjihati preko.

You can see Smeda vrata and Srebrna skrinja (closed) here.

>e
Ne mogu ovo preskočiti, ali se mogu zanjihati preko.
Konopac je korisniji ako ga nosiš, a ne samo imaš.

    *** YOU DIED ***

Would you like to RESTART, RESTORE a saved game, QUIT or UNDO the last command?

>undo
Kuhinja
[Previous turn undone.]

>w
Blagavaona

>u
Tavan
You can see Crna skrinja (closed), Sjajilo and Stit here.

>n
You can't go that way.

>w
You can't go that way.

* * *

>e
You can't go that way.

>s
You can't go that way.

>e
You can't go that way.

>e
You can't go that way.

>ee
That's not a verb I recognise.

>e
You can't go that way.

>d
Blagavaona

>u
Tavan
You can see Crna skrinja (closed), Sjajilo and Stit here.

>e
You can't go that way.

>e
You can't go that way.

You are gently but firmly ushered out, since Tavan is closing.

Blagavaona

>u
Tavan has been closed since 10:20 am.

>e
Kuhinja
Opis,  Mislim da se mogu zanjihati preko.

You can see Smeda vrata and Srebrna skrinja (closed) here.

>e
Ne mogu ovo preskočiti, ali se mogu zanjihati preko.
Konopac je korisniji ako ga nosiš, a ne samo imaš.

    *** YOU DIED ***

Would you like to RESTART, RESTORE a saved game, QUIT or UNDO the last command?

* * *

>undo
Kuhinja
[Previous turn undone.]

>n
Dnevna soba
Opis, Velika crvena vrata vode prema sjeveroistoku  Uvijek su zaključana 

You can see Crvena vrata and Zlatna skrinja (closed) here.

>ne
(first opening Crvena vrata)
It seems to be locked.

>open Crvena vrata
It seems to be locked.

>i
You are carrying:
  Konopac

>take crvena vrata
That's fixed in place.

>n
You can't go that way.

>s
Kuhinja
Opis,  Mislim da se mogu zanjihati preko.

You can see Smeda vrata and Srebrna skrinja (closed) here.

>s
Spavaca soba
Mjesto gdje provodis najvise vremena. Ispod prozora se nalazi krevet bez jastuka. Jedini izlaz su smeđa vrata koja su cesto zatvorena.

You can see Smeda vrata here.

>take smeda vrata
That's fixed in place.

>n
Kuhinja
Opis,  Mislim da se mogu zanjihati preko.

You can see Smeda vrata and Srebrna skrinja (closed) here.

>n
Dnevna soba
Opis, Velika crvena vrata vode prema sjeveroistoku  Uvijek su zaključana 

You can see Crvena vrata and Zlatna skrinja (closed) here.

* * *

>s
Kuhinja
Opis,  Mislim da se mogu zanjihati preko.

You can see Smeda vrata and Srebrna skrinja (closed) here.

>n
Dnevna soba
Opis, Velika crvena vrata vode prema sjeveroistoku  Uvijek su zaključana 

You can see Crvena vrata and Zlatna skrinja (closed) here.

* * *

>w
Blagovaonica
Stara soba sa žutim tapetama koja vodi prema tavanu.

You can see Konopac here.

>take Konopac
Taken.

* * *

>wear Konopac
You put on Konopac.

>e
Kuhinja
Ovdje uvijek dobijem nešto za pojesti, ali nisam stalno dobrodošao. Prolaz prema sjeveru i zapadu su slobodni. Mislim da se sad mogu zanjihati preko jame. 

You can see Frizider (closed) here.

>open Frizider
You open Frizider, revealing Kost.

>take kost
Taken.

>look Kost
Ne voliš kosti, ali kad si gladan sve je dobro.

>take off Konopac
You take off Konopac.

>drop Konopac
Dropped.

>e
Ne mogu ovo preskočiti, ali se mogu zanjihati preko s nečim.

    *** YOU DIED ***

Would you like to RESTART, RESTORE a saved game, QUIT or UNDO the last command?

>undo
Kuhinja
[Previous turn undone.]

>i
You are carrying:
  Kost

>look
Kuhinja
Ovdje uvijek dobijem nešto za pojesti, ali nisam stalno dobrodošao. Prolaz prema sjeveru i zapadu su slobodni. Mislim da se sad mogu zanjihati preko jame. 

You can see Konopac and Frizider (empty) here.

>take Konopac
Taken.

>e
Ne mogu ovo preskočiti, ali se mogu zanjihati preko s nečim.
Konopac je korisniji ako ga nosiš, a ne samo imaš.

    *** YOU DIED ***

Would you like to RESTART, RESTORE a saved game, QUIT or UNDO the last command?

>undo
Kuhinja
[Previous turn undone.]

>i
You are carrying:
  Konopac
  Kost

>wear Konopac
You put on Konopac.

>e
Ne mogu ovo preskočiti, ali se mogu zanjihati preko s nečim.
Uspio sam! Ovaj konopac će mi dobro doći i na povratku.

Hodnik
Hladan i dugačak hodnik koji vodi prema podrumu.

>drop Kost
Dropped.

>i
You are carrying:
  Konopac (being worn)

>d
Iz podruma se čuje glasno režanje.
Nije pametno ući u sobu gdje možeš postati nečiji zalogaj.

    *** YOU DIED ***

Would you like to RESTART, RESTORE a saved game, QUIT or UNDO the last command?

>undo
Hodnik
[Previous turn undone.]

>take kost
Taken.

>d
Iz podruma se čuje glasno režanje.
Ona kost iz Frižidera bi mogla biti korisna
Podrum
Vlažan i mračnji nego garaža. Ženski glas se ovdje ne čuje.

You can see Stvorenje here.

>i
You are carrying:
  Kost
  Konopac (being worn)

>look Stvorenje
Iz mraka te promatraju dva žarka oka. Režanje postaje sve jače i jače. Izgleda da je netko jako gladan. U kutu ispod svijetiljke vidiš zlatni ključ.

>daj Stvorenje kost
Režanje je prestalo i zamjenilo ga je mljackanje. Stvorenje se smirilo. Zgrabio si ključ i stavio ga u inventory.

>i
You are carrying:
  Zlatni kljuc
  Konopac (being worn)

>u
Hodnik
Hladan i dugačak hodnik koji vodi prema podrumu.

>w
Ne mogu ovo preskočiti, ali se mogu zanjihati preko s nečim.
Uspio sam! Ovaj konopac će mi dobro doći i na povratku.

Kuhinja
Ovdje uvijek dobijem nešto za pojesti, ali nisam stalno dobrodošao. Prolaz prema sjeveru i zapadu su slobodni. Mislim da se sad mogu zanjihati preko jame. 

You can see Frizider (empty) here.

>e
Ne mogu ovo preskočiti, ali se mogu zanjihati preko s nečim.
Uspio sam! Ovaj konopac će mi dobro doći i na povratku.

Hodnik
Hladan i dugačak hodnik koji vodi prema podrumu.

>drop Konopac
(first taking Konopac off)
Dropped.

>w
Ne mogu ovo preskočiti, ali se mogu zanjihati preko s nečim.

    *** YOU DIED ***

Would you like to RESTART, RESTORE a saved game, QUIT or UNDO the last command?

>undo
Hodnik
[Previous turn undone.]

>w
Ne mogu ovo preskočiti, ali se mogu zanjihati preko s nečim.

    *** YOU DIED ***

Would you like to RESTART, RESTORE a saved game, QUIT or UNDO the last command?

* * *

>undo
Hodnik
[Previous turn undone.]

>i
You are carrying:
  Zlatni kljuc

>e
You can't go that way.

>d
Iz podruma se čuje glasno režanje.
Nije pametno ući u sobu gdje možeš postati nečiji zalogaj.

    *** YOU DIED ***

Would you like to RESTART, RESTORE a saved game, QUIT or UNDO the last command?

>take Konopac
Please give one of the answers above.

Would you like to RESTART, RESTORE a saved game, QUIT or UNDO the last command?

>undo
Hodnik
[Previous turn undone.]

>take Konopac
Taken.

>i
You are carrying:
  Konopac
  Zlatni kljuc

>drop konopac
Dropped.

>w
Ne mogu ovo preskočiti, ali se mogu zanjihati preko s nečim.

    *** YOU DIED ***

Would you like to RESTART, RESTORE a saved game, QUIT or UNDO the last command?

* * *

>undo
Hodnik
[Previous turn undone.]

>look
Hodnik
Hladan i dugačak hodnik koji vodi prema podrumu.

You can see Konopac here.

>w
Ne mogu ovo preskočiti, ali se mogu zanjihati preko s nečim.

    *** YOU DIED ***

Would you like to RESTART, RESTORE a saved game, QUIT or UNDO the last command?

* * *

>undo
Hodnik
[Previous turn undone.]

>take konopac
Taken.

>w
Ne mogu ovo preskočiti, ali se mogu zanjihati preko s nečim.
Konopac je korisniji ako ga nosiš, a ne samo imaš.

    *** YOU DIED ***

Would you like to RESTART, RESTORE a saved game, QUIT or UNDO the last command?

>wear konopac
Please give one of the answers above.

Would you like to RESTART, RESTORE a saved game, QUIT or UNDO the last command?

>undo
Hodnik
[Previous turn undone.]

>wear konopac
You put on Konopac.

>w
Ne mogu ovo preskočiti, ali se mogu zanjihati preko s nečim.
Uspio sam! Ovaj konopac će mi dobro doći i na povratku.

Kuhinja
Ovdje uvijek dobijem nešto za pojesti, ali nisam stalno dobrodošao. Prolaz prema sjeveru i zapadu su slobodni. Mislim da se sad mogu zanjihati preko jame. 

You can see Frizider (empty) here.

>w
Blagovaonica
Stara soba sa žutim tapetama koja vodi prema tavanu.

>e
Kuhinja
Ovdje uvijek dobijem nešto za pojesti, ali nisam stalno dobrodošao. Prolaz prema sjeveru i zapadu su slobodni. Mislim da se sad mogu zanjihati preko jame. 

You can see Frizider (empty) here.

>n
Dnevna soba
Velika soba puna svijetla. Put prema sjeverozapadu je otvoren. Velika crvena vrata vode prema sjeveroistoku. Rijetko smijem sam proći kroz ta vrata. Uvijek su zaključana.

You can see Zlatna skrinja (closed) here.

>nw
Radna soba
Lijepo uređena soba s tvojom slikom na stolu i imenom na poleđini - Eugen. Put prema sjeveru je slobodan. Opasne rotirajuće oštrice blokiraju put prema zapadu.

>w
Ne mogu ovo proći bez zaštite.

    *** YOU DIED ***

Would you like to RESTART, RESTORE a saved game, QUIT or UNDO the last command?

>undo
Radna soba
[Previous turn undone.]

>s
You can't go that way.

>se
Dnevna soba
Velika soba puna svijetla. Put prema sjeverozapadu je otvoren. Velika crvena vrata vode prema sjeveroistoku. Rijetko smijem sam proći kroz ta vrata. Uvijek su zaključana.

You can see Zlatna skrinja (closed) here.

>look zlatna skrinja
You see nothing special about Zlatna skrinja.

>open zlatna skrinja
It seems to be locked.

>i
You are carrying:
  Konopac (being worn)
  Zlatni kljuc

>unlock zlatna skrinja with zlati kljuc
You can't see any such thing.

>unlock zlatna skrinja with zlatni kljuc
You unlock Zlatna skrinja.

>open zlatna skrinja
You open Zlatna skrinja, revealing Zlatnici.

>look zlatnici
Zlatnici različitih oblika. Nekima bi se činili čudnima, ali ne i tebi.

* * *

>take zaltnici
You can't see any such thing.

>take zlatnici
Taken.

>look zlatnici
1500 Zlatnika.

>s
Kuhinja
Ovdje uvijek dobijem nešto za pojesti, ali nisam stalno dobrodošao. Prolaz prema sjeveru i zapadu su slobodni. Mislim da se sad mogu zanjihati preko jame. 

You can see Frizider (empty) here.

>w
Blagovaonica
Stara soba sa žutim tapetama koja vodi prema tavanu.

>u
Tavan je zaključan od 10:45 am zbog vrućine.

>u
Tavan je zaključan od 10:45 am zbog vrućine.

>i
You are carrying:
  Zlatnici
  Konopac (being worn)
  Zlatni kljuc

>look Zlatnici
1500 Zlatnika.

>look crna Skrinja
You can't see any such thing.

>open crna skrinja
You can't see any such thing.

>take crni kljuc
You can't see any such thing.

>put crni kljun on blagajna
You can't see any such thing.

>put crni kljuc on blagajna
You can't see any such thing.

>i
You are carrying:
  Zlatnici
  Konopac (being worn)
  Zlatni kljuc

>put zlatnici on blagajna
You can't see any such thing.

>take crni kljuc
You can't see any such thing.

>unlock crna skrinja with crni kljuc
You can't see any such thing.

>open crna skrinja
You can't see any such thing.

>undo
Blagovaonica
[Previous turn undone.]

>look zlatnici
1500 Zlatnika.

>look taan
You can't see any such thing.

>look tavan
You can't see any such thing.

>s
You can't go that way.

>d
You can't go that way.

>u
Tavan je zaključan od 10:45 am zbog vrućine.

* * *

>i
You are carrying:
  Zlatnici
  Konopac (being worn)
  Zlatni kljuc

>put kobasica on blagajna
You can't see any such thing.

>put zlatnici on blagajna
You can't see any such thing.

>take kobasica
You can't see any such thing.

>u
Tavan je zaključan od 10:45 am zbog vrućine.

>d
You can't go that way.

>pojedi Kobasicu
You can't see any such thing.

>i
You are carrying:
  Zlatnici
  Konopac (being worn)
  Zlatni kljuc

>pojedi Kobasica
You can't see any such thing.

>undo
Blagovaonica
[Previous turn undone.]

>u
Tavan je zaključan od 10:45 am zbog vrućine.

* * *

>i
You are carrying:
  Zlatnici
  Konopac (being worn)
  Zlatni kljuc

>i
You are carrying:
  Zlatnici
  Konopac (being worn)
  Zlatni kljuc

* * *

>undo
Blagovaonica
[Previous turn undone.]

>i
You are carrying:
  Zlatnici
  Konopac (being worn)
  Zlatni kljuc

>d
You can't go that way.

* * *

>u
Tavan je zaključan od 10:45 am zbog vrućine.

>look zlatnici
1500 Zlatnika.

>look oklolp
You can't see any such thing.

>look oklop
You can't see any such thing.

>look crveni kljuc
You can't see any such thing.

>put oklop on blagajna
You can't see any such thing.

>put zlatnici on blagajna
You can't see any such thing.

>take oklop
You can't see any such thing.

>put crveni kljuc on blagajna
You can't see any such thing.

>put zlatnici on blagajna
You can't see any such thing.

>look oglrica
You can't see any such thing.

>e
Kuhinja
Ovdje uvijek dobijem nešto za pojesti, ali nisam stalno dobrodošao. Prolaz prema sjeveru i zapadu su slobodni. Mislim da se sad mogu zanjihati preko jame. 

You can see Frizider (empty) here.

>u
You can't go that way.

>look
Kuhinja
Ovdje uvijek dobijem nešto za pojesti, ali nisam stalno dobrodošao. Prolaz prema sjeveru i zapadu su slobodni. Mislim da se sad mogu zanjihati preko jame. 

You can see Frizider (empty) here.

>i
You are carrying:
  Zlatnici
  Konopac (being worn)
  Zlatni kljuc

>look zlatnici
1500 Zlatnika.

>look zlatnici
1500 Zlatnika.

>i
You are carrying:
  Zlatnici
  Konopac (being worn)
  Zlatni kljuc

>take crveni kljuc
You can't see any such thing.

>look zlatnici
1500 Zlatnika.

>look
Kuhinja
Ovdje uvijek dobijem nešto za pojesti, ali nisam stalno dobrodošao. Prolaz prema sjeveru i zapadu su slobodni. Mislim da se sad mogu zanjihati preko jame. 

You can see Frizider (empty) here.

>ask Habdul about a
You can't see any such thing.

>ask Habdul about posao
You can't see any such thing.

>ask Habdul about Zenski glas
You can't see any such thing.

>d
You can't go that way.

>i
You are carrying:
  Zlatnici
  Konopac (being worn)
  Zlatni kljuc

>e
Ne mogu ovo preskočiti, ali se mogu zanjihati preko s nečim.
Uspio sam! Ovaj konopac će mi dobro doći i na povratku.

Hodnik
Hladan i dugačak hodnik koji vodi prema podrumu.

>n
You can't go that way.

>ne
You can't go that way.

>look crvena vrata
You can't see any such thing.

>open crvena vrata
You can't see any such thing.

>unlock crvena vrata
You can't see any such thing.

>crveni kljuc
That's not a verb I recognise.

>open crvena vrata
You can't see any such thing.

>se
You can't go that way.

>sw
You can't go that way.

>look
Hodnik
Hladan i dugačak hodnik koji vodi prema podrumu.

>nw
You can't go that way.

>se
You can't go that way.

>drop oklop
You can't see any such thing.

>nw
You can't go that way.

>i
You are carrying:
  Zlatnici
  Konopac (being worn)
  Zlatni kljuc

>look
Hodnik
Hladan i dugačak hodnik koji vodi prema podrumu.

>se
You can't go that way.

>take oklop
You can't see any such thing.

>nw
You can't go that way.

>w
Ne mogu ovo preskočiti, ali se mogu zanjihati preko s nečim.
Uspio sam! Ovaj konopac će mi dobro doći i na povratku.

Kuhinja
Ovdje uvijek dobijem nešto za pojesti, ali nisam stalno dobrodošao. Prolaz prema sjeveru i zapadu su slobodni. Mislim da se sad mogu zanjihati preko jame. 

You can see Frizider (empty) here.

>undo
Hodnik
[Previous turn undone.]

>i
You are carrying:
  Zlatnici
  Konopac (being worn)
  Zlatni kljuc

>wear oklop
You can't see any such thing.

>take off konopac
You take off Konopac.

>wear oklop
You can't see any such thing.

>take off oklop
You can't see any such thing.

>i
You are carrying:
  Zlatnici
  Konopac
  Zlatni kljuc

>wear konopac
You put on Konopac.

>wear oklop
You can't see any such thing.

>i
You are carrying:
  Zlatnici
  Konopac (being worn)
  Zlatni kljuc

* * *

>look
Hodnik
Hladan i dugačak hodnik koji vodi prema podrumu.

>w
Ne mogu ovo preskočiti, ali se mogu zanjihati preko s nečim.
Uspio sam! Ovaj konopac će mi dobro doći i na povratku.

Kuhinja
Ovdje uvijek dobijem nešto za pojesti, ali nisam stalno dobrodošao. Prolaz prema sjeveru i zapadu su slobodni. Mislim da se sad mogu zanjihati preko jame. 

You can see Frizider (empty) here.

* * *

>e
Ne mogu ovo preskočiti, ali se mogu zanjihati preko s nečim.
Uspio sam! Ovaj konopac će mi dobro doći i na povratku.

Hodnik
Hladan i dugačak hodnik koji vodi prema podrumu.

>undo
Kuhinja
[Previous turn undone.]

>e
Ne mogu ovo preskočiti, ali se mogu zanjihati preko s nečim.
Uspio sam! Ovaj konopac će mi dobro doći i na povratku.

Hodnik
Hladan i dugačak hodnik koji vodi prema podrumu.

* * *

>undo
Kuhinja
[Previous turn undone.]

>i
You are carrying:
  Zlatnici
  Konopac (being worn)
  Zlatni kljuc

>look
Kuhinja
Ovdje uvijek dobijem nešto za pojesti, ali nisam stalno dobrodošao. Prolaz prema sjeveru i zapadu su slobodni. Mislim da se sad mogu zanjihati preko jame. 

You can see Frizider (empty) here.

>Eugen
Da tako se zovem, ali mi to sada ne pomaže.

>Mijau
Nitko me ne cuje.

* * *

>w
Blagovaonica
Stara soba sa žutim tapetama koja vodi prema tavanu.

You can see Konopac here.

>take konopac
Taken.

>e
Kuhinja
Na sjeveru nalazi se Dnevna soba dok su na istoku vrata sa zamkom koja vode prema hodniku.

You can see Smeda vrata and Srebrna skrinja (closed) here.

* * *

>take kost
Taken.

>e
Ne mogu ovo preskočiti.
Konopac je korisniji ako ga nosiš a ne samo imaš. YOU DIED

    *** The End ***

Would you like to RESTART, RESTORE a saved game, QUIT or UNDO the last command?

>undo
Kuhinja
[Previous turn undone.]

>wear konopac
You put on Konopac.

>e
Ne mogu ovo preskočiti.
Konopac će posluziti i na povrtaku
Hodnik
Dugi i hladni hodnik.

* * *

>d
Glasno režanje s druge strane. Ona kost bi mogla biti korisna
Podrum
Hladan i jos mracniji nego tvoja spavaća soba.

You can see Stvorenje here.

>daj Stvorneje kost
You can't see any such thing.

>daj Stvorenje kost
Režanje je prestalo i zamjenilo ga je mljackanje. Stvorenje se smirilo. Sada je prilika za ugrabiti ključ.

* * *

>e
You can't go that way.

>w
Ne mogu ovo preskočiti.
Konopac će posluziti i na povrtaku
Kuhinja
Na sjeveru nalazi se Dnevna soba dok su na istoku vrata sa zamkom koja vode prema hodniku.

You can see Smeda vrata and Srebrna skrinja (empty) here.

* * *

>w
Blagavaona

>u
Tavan
Došli ste na tavan. Ovdje vidis stranca u bjelo crnom kaputu koji se cini nesto prodaje.

You can see Crna skrinja (closed), Sjajilo, Labelo and Stit here.

>take labelo
Moraš prvo platiti labelo na kasi!

* * *

>put fond on kasa
Hvala Vam na kupnji i doviđenja. NE ZABORAVITE uzeti labelo! Preostalo Vam je još 197 €.

>take stit
Moraš prvo platiti stit na kasi!

* * *

>put fond on kasa
Hvala Vam na kupnji i doviđenja. NE ZABORAVITE uzeti labelo! Preostalo Vam je još 147 €.

>take labelo
Taken.

>take stit
Taken.

>wear stit
You put on Stit.

>d
Blagavaona

* * *

>n
Dnevna soba
Na sjeveroistoku se nalaze Crvena vrata dok je na sjeverozapadu kupaona.

You can see Zlatna skrinja (empty) here.

>ne
(first opening Crvena vrata)
It seems to be locked.

* * *

>open crvena vrata
You open Crvena vrata.

>go through
What do you want to go through?

>crvena vrata
Smocnica
U sobi se nalazi bocica na sredini stola.

You can see Bocica here.

>take bocica
Taken.

* * *

>nw
Kupaona
Bijela soba s tvojim imenom na zidu - Eugen.

>Eugen
Nema ucinka.

>west
Ne mogu ovo preskočiti.
Konopac će posluziti i na povrtaku
Vrt
Stit je bio jednokratan. Nema natrag.

>east
Kupaona
Bijela soba s tvojim imenom na zidu - Eugen.

>west
Ne mogu ovo preskočiti.
Konopac će posluziti i na povrtaku
Vrt
Stit je bio jednokratan. Nema natrag.

* * *

>undo
Kupaona
[Previous turn undone.]

>i
You are carrying:
  Bocica
  Stit (being worn)
  Labelo
  Fond
  Zlatni kljuc
  Konopac (being worn)

>w
Ne mogu ovo preskočiti.
Konopac će posluziti i na povrtaku
Vrt
Stit je bio jednokratan. Nema natrag.

>Eugen
Bacen si u zrak
Radna soba
Konacno si dosao do zenskog glasa.

>Mijau
*** Gladan sam. ***

Would you like to RESTART, RESTORE a saved game, QUIT or UNDO the last command?

* * *

>wear konopac
You put on Konopac.

>e
Kuhinja
Ovdje uvijek dobijem nešto za pojesti, ali nisam stalno dobrodošao. Prolaz prema sjeveru i zapadu su slobodni. Mislim da se sad mogu zanjihati preko jame. 

You can see Frizider (closed) here.

>open frizder
You can't see any such thing.

>take Kost
You can't see any such thing.

>look Kost
You can't see any such thing.

* * *

>e
Kuhinja
Ovdje uvijek dobijem nešto za pojesti, ali nisam stalno dobrodošao. Prolaz prema sjeveru i zapadu su slobodni. Mislim da se sad mogu zanjihati preko jame. 

You can see Frizider (closed) here.

>open srebrna skrinja
You open Srebrna skrinja, revealing Kost.

* * *

>put labelo on kasa
Račun za labelo je 3 €. Molim Vas stavite fond na kasu.

>put fond on kasa
You can't see any such thing.

>d
Blagavaona

* * *

>e
Kuhinja
Na sjeveru nalazi se Dnevna soba dok su na istoku vrata sa zamkom koja vode prema hodniku.

You can see Smeda vrata and Srebrna skrinja (empty) here.

>n
Dnevna soba
Na sjeveroistoku se nalaze Crvena vrata dok je na sjeverozapadu kupaona.

You can see Zlatna skrinja (closed) here.

* * *

>take fond
Taken.

>w
You can't go that way.

* * *

>put fond on kasa
Hvala Vam na kupnji i doviđenja. NE ZABORAVITE uzeti labelo! Preostalo Vam je još 197 €.

>tae labelo
That's not a verb I recognise.

>take labelo
Taken.

* * *

>ne
(first opening Crvena vrata)
It seems to be locked.

>unlock Crvena vrata with Labelo
You unlock Crvena vrata.

>ne
(first opening Crvena vrata)

Smocnica
U sobi se nalazi bocica na sredini stola.

You can see Bocica here.

>se
You can't go that way.

>sw
Dnevna soba
Na sjeveroistoku se nalaze Crvena vrata dok je na sjeverozapadu kupaona.

You can see Zlatna skrinja (empty) here.

>nw
Cini se da m treba nesto maso kako bi ovdje ušao

>ne
Smocnica
U sobi se nalazi bocica na sredini stola.

You can see Bocica here.

>take bocica
Taken.

* * *

>sw
Dnevna soba
Na sjeveroistoku se nalaze Crvena vrata dok je na sjeverozapadu kupaona.

You can see Zlatna skrinja (empty) here.

>ne
Smocnica
U sobi se nalazi bocica na sredini stola.

>nw
You can't go that way.

* * *

>se
You can't go that way.

>i
You are carrying:
  Bocica
  Labelo
  Fond
  Zlatni kljuc
  Konopac (being worn)

>sw
Dnevna soba
Na sjeveroistoku se nalaze Crvena vrata dok je na sjeverozapadu kupaona.

You can see Zlatna skrinja (empty) here.

* * *

9 zivota
An Interactive Fiction by Andrej
Release 1 / Serial number 230717 / Inform 7 v10.1.2 / D

U daljini čuješ ženski glas. Toliko je glasan da te probudio. Osjećaš se ukočeno i umorno kao da uopće nisi spavao. Mali prozor iznad kreveta je jedini izvor svijetla u inače potpuno mračnoj sobi. Ne bojiš se mraka, štoviše on ti godi. Odlučiš krenuti prema ženskom glasu.

Garaza (on Krevet)
Mjesto gdje provodiš noći odmarajući se. Ispod prozora se nalazi krevet bez jastuka. Jedini izlaz su smeđa vrata na sjeveru.

>stand up
You get off Krevet.

Spavaca soba
Mjesto gdje provodis najvise vremena. Ispod prozora se nalazi krevet bez jastuka. Jedini izlaz su smeđa vrata koja su cesto zatvorena.

 Vrata su otvorena.

>lay down
That's not a verb I recognise.

>get on krevet
That's not something you can enter.